11111111111
11111111111
1CCCCCCCCP1
11111111111