11111111111
11111111111
1ECCCCCCCP1
11111111111