1111111111
1000010001
10C0010001
1000E00001
1111111011
10P0000001
1111111111