1111111111
10000E0001
10000C0001
1000P00001
1000000001
1000000001
1111111111